Height 9
Width 9

@ layer1 start, heihei
LAYER1_START
1 1 1 1 1 1 1 1 1
1 1 1 1 1 1 1 1 1
1 1 1 1 1 1 1 1 1
1 1 1 1 1 1 1 1 1
1 1 1 1 1 1 1 1 1
1 1 1 1 1 1 1 1 1
1 1 1 1 1 1 1 1 1
1 1 1 1 1 1 1 1 1
1 1 1 1 1 1 1 1 1
LAYER1_END

@layer2 start, haha
LAYER2_START
1 1 1 1 1 1 1 1 1
2 2 2 1 1 2 1 1 1
1 1 1 1 1 2 1 1 1
1 1 1 2 2 2 1 1 1
1 1 1 1 1 2 1 1 1
1 1 2 1 1 1 1 1 1
2 2 1 1 2 2 1 2 1
1 1 1 1 1 2 1 1 1
1 1 2 2 1 2 1 1 1
LAYER2_END

FLAG_START
1 1 1 1 1 1 1 1 1
2 2 2 1 1 2 1 1 1
1 1 1 1 1 2 1 1 1
1 1 1 2 2 2 1 1 1
1 1 1 1 1 2 1 1 1
1 1 2 1 1 1 1 1 1
2 2 1 1 2 2 1 2 1
1 1 1 1 1 2 1 1 1
1 1 2 2 1 2 1 1 1
FLAG_END
