Height 5
Width 5

LAYER1_START
1 1 1 1 1
1 1 1 1 1
1 1 1 1 1
1 1 1 1 1
1 1 1 1 1
LAYER1_END
LAYER2_START
1 1 1 1 1
1 1 2 1 1
1 1 2 1 1
2 1 1 2 2
1 1 1 1 1
LAYER2_END

FLAG_START
1 1 1 1 1
1 1 2 1 1
1 1 2 1 1
2 1 1 2 2
1 1 1 1 1
FLAG_END